11111
1P001
10001
1C101
100E1
11111