111111111111111111111
111111010101P00000001
1111C0101010101011111
1100000C0001111000011
10101010110101010E101
10000011111C111111111
100000001010101010101
1011001010101010E1111
1111111111111111C1111
110111100000111111111
111111111111111111111