1111111111111111
100010C000000001
1000P00001111111
100C00000100E001
1111111111111111