111111111111111111111111111111111111111111
1000000000000000000011000000000000000C0001
101111111110111111101101111111111101111101
101000000000000000101101000000000000000101
101011111111111110100001011111111111110101
10101000000000001010110101000000000C010101
101010111111011010101101010111111011010101
101010100000001010101101010100000001000101
101010101111101010101101010101111101010101
101010101000101010101001010101000001010101
1010101010P00010101000110101010C0101010101
101000101000101010101101010101000101010101
101010101111101010101101010101111101010101
101010100000001010101101010100000001010101
101C10111111111010101101010110111111010101
101010000000000010101101010000000000010101
101011111111111110101101011101111111110101
101000000000000000100001000000C00000000101
101111111011111111101101111111111111111101
1000000000000000000001000000C0000000000001
111011111111111110110011111111110111111111
111011111111111110111001111111110111111111
100000000000000000001100000000000000000001
101111111111111111100001111111111011111101
101000000000000000101101000000000000000101
101011111111111110101101011111111101110101
101010000000000010101101010000000000010101
101010111111111010101101010111111111010101
10001000C00000101010110101010000000101C101
101010101111101000101101010101101100010101
1010101010001010101011C1010101000101010101
1010101010C01000101011010101010E0101010101
101010101000001010100001010101000101010101
101010101111101010101101010101101101110101
101000100000001010101101010100000001010101
101010111111111010101100010111011111010101
10101000000000001010000101000000000C010101
101011110111111110101101011111011111110101
101000000000000000101101000000000000000101
101111011111011111101101111111111111111101
10000000000000000000110000000000000C000001
111111111111111111111111111111111111111111